####Q#######
#  ...     #
#   ..     #
#   ..     #
#   .C     #
#   ...    #
#    ...   #
#     @....x
#       ...#
#          #
#          #
############
